{
    "map": [
        [0,0,0,0,0,0,0,0,0,0,0,0,0,0],
        [1,1,1,1,0,1,1,1,1,1,0,0,0,0],
        [0,0,0,1,0,1,0,0,0,1,1,1,0,0],
        [0,1,1,1,0,1,0,0,0,1,1,1,0,0],
        [0,1,0,0,0,1,0,0,0,0,0,1,0,0],
        [0,1,0,0,0,1,0,0,1,1,1,1,0,0],
        [0,1,1,1,1,1,0,0,1,1,1,1,1,1]
    ],
    "startPos": [0,1],
    "Money" : 1000,
    "Health": 5,
    "PreviewImage" : "Preview.png"
}