{
    "map": [
        [0,0,0,0,0,0,0,0,0,0,0,0,0,0,0],
        [0,5,1,1,1,1,1,6,0,5,1,1,1,6,0],
        [1,3,0,0,0,0,0,3,0,2,0,0,0,2,0],
        [0,0,0,5,1,1,1,3,0,2,0,0,0,2,0],
        [0,5,1,3,0,0,0,0,0,2,0,0,0,2,0],
        [0,2,0,0,0,5,1,6,0,2,0,0,0,2,0],
        [0,2,0,0,0,2,0,7,1,3,0,0,0,2,0],
        [0,7,1,1,1,3,0,0,0,0,0,0,0,2,0]
    ],
    "startPos": [0,2],
    "Money" : 100,
    "PreviewImage" : "Preview.png"
}