{
    "map": [
        [0,0,0,0,0,0,0,0,0,0,0,0,0,0,0],
        [0,1,1,1,1,1,1,1,0,1,1,1,1,1,0],
        [1,1,0,0,0,0,0,1,0,1,0,0,0,1,0],
        [0,0,0,1,1,1,1,1,0,1,0,0,0,1,0],
        [0,1,1,1,0,0,0,0,0,1,0,0,0,1,0],
        [0,1,0,0,0,1,1,1,0,1,0,0,0,1,0],
        [0,1,0,0,0,1,0,1,1,1,0,0,0,1,0],
        [0,1,1,1,1,1,0,0,0,0,0,0,0,1,0]
    ],
    "startPos": [0,2],
    "Money" : 120,
    "Health": 10,
    "PreviewImage" : "Preview.png"
}